3 5 5 3 5 3 5 3 3 3 5 5 5 5 5 3
7 9 9 3 2 3 2 3 3 3 9 9 9 9 9 8
3 3 9 9 9 3 9 9 9 9 9 3 3 3 3 3
7 2 9 3 3 3 9 3 3 3 9 9 9 9 9 8
7 2 9 9 9 9 9 3 9 3 9 3 3 3 9 3
3 3 3 3 3 3 3 3 9 9 9 3 2 9 9 8
7 9 9 9 9 9 9 9 9 3 3 3 3 3 9 8
7 9 3 3 3 3 3 3 3 3 9 9 9 9 9 8
7 9 9 9 9 9 9 9 9 3 9 3 3 9 3 3
3 2 3 3 3 3 3 3 9 3 9 2 9 9 9 8
3 2 9 9 9 9 9 9 9 3 3 2 9 3 9 8
3 3 6 6 6 10 6 6 6 3 3 3 6 3 6 3