4 4 4 4 4 4 4 4 4 4 4 4 4 4 4 4
4 11 4 13 4 13 11 11 11 11 11 11 13 4 11 4
4 11 4 11 4 4 4 11 4 13 4 11 4 4 11 10
4 11 4 11 11 11 11 11 4 4 4 11 11 4 11 4
4 11 4 11 4 4 4 4 4 13 4 11 11 4 11 4
4 11 11 11 4 11 11 11 11 11 11 11 4 4 11 4
4 4 4 4 4 11 4 4 4 4 4 11 11 4 11 4
4 11 4 4 11 11 11 4 13 13 4 4 11 4 11 4
4 11 11 11 11 11 11 11 11 11 4 13 11 11 11 4
4 11 4 4 4 4 4 4 4 11 4 4 4 4 4 4
4 11 11 13 13 4 13 11 11 11 11 11 11 11 11 4
4 4 4 4 4 4 4 4 4 4 4 4 4 4 4 4