12 12 11 12 12 12 12 12 12 12 12 12 12 12 12 12
12 11 11 11 11 11 12 12 2 11 11 11 12 2 12 12
12 12 11 12 12 11 12 2 12 11 12 11 12 11 12 12
12 11 11 12 2 2 12 11 11 11 12 11 11 11 2 12
12 11 12 12 11 11 12 11 12 12 12 11 12 12 12 12
12 11 12 11 11 11 11 11 12 11 11 11 12 2 2 12
12 11 12 11 12 12 12 11 12 11 12 11 11 11 11 12
12 11 11 11 11 2 12 11 12 11 12 12 12 12 12 12
12 12 11 12 12 2 12 11 12 11 11 11 11 11 11 12
12 11 11 12 12 11 12 11 12 12 12 12 12 12 11 12
12 2 2 2 11 11 11 11 11 11 11 10 12 11 11 12
12 12 12 12 12 12 12 12 12 12 12 12 12 12 12 12