4 4 0 4 4 4 4 4 4 4 4 4 4 4 4 4
4 0 0 0 0 0 4 0 0 0 0 0 0 0 2 4
4 4 0 4 4 0 4 4 4 4 4 0 4 4 4 4
4 0 0 4 2 2 4 0 0 2 4 0 0 0 0 4
4 0 4 4 0 0 4 0 4 4 4 0 4 4 4 4
4 0 4 0 0 0 0 0 0 0 0 0 4 2 2 4
4 0 4 0 4 4 4 0 4 4 4 0 0 0 0 4
4 0 0 0 4 2 4 0 4 0 4 0 4 4 4 4
4 4 0 4 4 0 4 0 2 0 0 0 0 0 0 4
4 0 0 4 0 0 0 0 4 4 4 4 4 4 0 4
4 2 2 4 0 0 0 0 0 0 0 2 4 0 0 4
4 4 4 4 4 10 4 4 4 4 4 4 4 4 4 4