15 15 15 15 15 15 15 15 15 15 10 15 15 15 15 15
15 16 16 15 16 16 16 16 16 16 16 16 14 16 14 15
15 15 16 15 16 15 15 15 15 15 15 15 15 16 15 15
15 16 16 15 16 14 15 16 16 16 15 16 16 16 14 15
15 16 15 15 16 16 15 16 15 16 15 16 15 15 15 15
15 16 16 15 16 16 16 16 15 16 16 16 15 14 14 15
15 15 16 16 15 15 16 15 15 15 15 16 16 16 16 15
15 15 15 16 15 14 16 15 15 14 15 16 15 15 15 15
15 14 16 16 15 16 16 16 16 16 16 16 16 16 16 15
15 15 15 16 15 16 15 16 15 15 15 15 15 15 16 15
15 14 16 16 16 16 15 16 16 16 16 14 15 16 16 15
15 15 15 15 15 15 15 15 15 15 15 15 15 15 15 15