15 15 9 15 15 15 15 15 15 15 15 15 15 15 15 15
15 9 9 9 9 15 9 9 9 9 9 9 9 9 13 15
15 15 9 15 9 9 9 15 15 15 15 13 15 15 15 15
15 9 9 15 13 13 15 15 9 9 9 9 9 9 13 15
15 9 15 15 9 9 15 9 9 15 15 9 15 15 15 15
15 9 15 9 9 9 9 9 15 13 9 9 15 13 13 15
15 9 15 15 15 15 15 9 15 15 15 9 9 9 9 10
15 9 9 13 15 9 9 9 15 13 15 15 15 15 15 15
15 15 9 15 15 9 15 15 13 9 9 9 9 9 9 15
15 13 9 9 9 9 15 13 15 15 9 15 15 15 9 15
15 13 13 15 13 9 9 9 9 9 9 15 13 9 9 15
15 15 15 15 15 15 15 15 15 15 15 15 15 15 15 15