4 4 11 4 4 4 4 4 4 4 4 4 4 4 4 4
4 11 11 11 11 11 11 11 11 11 11 11 11 2 4 4
4 4 4 4 4 4 4 4 4 11 4 11 4 4 4 4
4 11 11 4 2 2 4 11 2 2 4 11 11 11 2 4
4 11 4 4 11 11 4 11 4 4 4 11 4 4 4 4
4 2 4 11 11 11 11 11 11 11 11 11 4 2 2 4
4 4 4 11 4 4 4 4 4 4 4 11 11 11 11 4
4 11 11 11 4 11 11 11 11 11 4 11 4 4 4 4
10 11 11 4 4 2 4 11 4 11 11 11 11 2 4 4
4 11 11 4 11 11 11 11 4 4 4 4 4 4 4 4
4 2 2 4 11 11 11 11 11 11 11 11 11 11 11 4
4 4 4 4 4 4 4 4 4 4 4 4 4 4 4 4